2 15 31
###############################
#p   1l 2 *  1  * 2 * * **1*  #
# # # #*# # #*#*# # # #*#*#*# #
#w  *   1 *  ***  1       * * #
#*# # # # #*# # #*#*# # # # #*#
#f   b* * *   x   *  *    *   #
# # # # # # # # # #*# # # # # #
#*  *   x  *  * *  *     *    #
# # # # #*# # # #*#*# # # # # #
#*    **  *       *           #
# #*# # # # # # #*# # # # # # #
#   *   *    *   * 1 *        #
# # # # # # # # # # # # # # # #
# ** *     *         *  **d*  #
###############################
null
