1 15 31
###############################
#p sd1l 1 *  1  * 2 * * **1*  #
# # # #*# # #*#*# # # #*#*#*# #
#w x*   1 *  ***  1     2 * * #
#*# # # # #*# # #*#*# # # # #*#
#f   b* * *   x   *  *   2*   #
# # # # # # # # # #*# # # # # #
#*  *      *  * *  *     *    #
# # # # #*# # # #*#*# # # # # #
#*    **  *       *           #
# #*# # # # # # #*# # # # # # #
#   *   *    *   *1 * 1   2   #
# # # # # # # # # # # # # # # #
# ** *     *    x    *  **d*  #
###############################

