2 15 31
###############################
#p    l 2 *     *   * * ** *  #
# # # #*# # #*#*# # # #*#*#*# #
#w  *   1 *  ***          * * #
#*# # # # #*# # #*#*# # # # #*#
#f   b* * *   x   *  *    *   #
# # # # # # # # # #*# # # # # #
#*  * 4 x  *  * *  *     *    #
# # # # #*# # # #*#*# # # # # #
#*  1 **  *   3   *           #
# #*# # # # # # #*# # # # # # #
#   *   *    *   * 1 *        #
# # # # # # # # # # # # # # # #
# ** *     *         *  **d*  #
###############################
null